ああ	ああ	Ah!, Oh!
会う	あう	to meet, to see
青	あお	blue
青い	あおい	blue
赤	あか	red
赤い	あかい	red
明るい	あかるい	bright (in reference to personality or weather); cheerful
秋	あき	fall (season)
開く	あく	to open, to become open
開ける	あける	to open (v.t.)
上げる	あげる	to raise, to lift
朝	あさ	morning
朝御飯	あさごはん	breakfast
明後日	あさって	day after tomorrow
足; 脚	あし	foot; leg
明日	あした	tomorrow
あそこ	あそこ	there, over there, that place
遊ぶ	あそぶ	to play; to spend time pleasantly; to hang out
暖かい	あたたかい	warm
頭	あたま	head
新しい	あたらしい	new
あちら	あちら	this way (polite)
暑い	あつい	hot (in reference to weather), warm
熱い	あつい	hot (objects)
厚い	あつい	kind, warm(hearted), thick, deep
あっち	あっち	over there
後	あと	afterwards (later); in the future; the rest; since then
あなた	あなた	you
兄	あに	(my) older brother (humble)
姉	あね	(my) older sister (humble)
アパート	アパート	apartment (abbr.)
あの	あの	that over there; like that, that way; um...
浴びる	あびる	to bathe, to shower
危ない	あぶない	dangerous, critical
甘い	あまい	generous, sweet
余り	あまり	not very; surplus  テレビなら 家[うち]に 一[ひと]つ 余[あま]ってますけど I have an extra TV at home.
雨	あめ	rain
飴	あめ	(hard) candy
洗う	あらう	to wash
在る	ある	to be, to have
有る	ある	to be, to have
歩く	あるく	to walk
あれ	あれ	that one (over there)
いい; よい	いい; よい	good
いいえ	いいえ	no, not at all
言う	いう	to say
家	いえ	house, home
いかが	いかが	how, in what way  ワインはいかがですか。 Would you like some wine?
行く	いく; ゆく	to go
いくつ	いくつ	how many, how old
いくら	いくら	how much, how many
池	いけ	pond
医者	いしゃ	doctor; physician
椅子	いす	chair
忙しい	いそがしい	busy (people, days)
痛い	いたい	hurt; painful; sore
一	いち	one
一日	いちにち	one day (duration)
一番	いちばん	best (most), first, number one
いつ	いつ	when
五日	いつか	five days; fifth day of the month
一緒	いっしょ	together
五つ	いつつ	five things
いつも	いつも	always, usually, every time, never (with neg. verb)
犬	いぬ	dog
今	いま	now
意味	いみ	meaning, significance
妹	いもうと	younger sister (humble)
嫌	いや	disagreeable, detestable, unpleasant
入口	いりぐち	entrance
居る	いる	(humble) to be (animate), to exist
要る	いる	to need
入れる	いれる	to put in
色	いろ	color
色々	いろいろ	various
上	うえ	above (up, top, etc.), over, on top of
後ろ	うしろ	back, behind, rear
薄い	うすい	thin, weak  この 料理[りょうり]は 味[あじ]が 薄[うす]い  もう 春[はる]だ。 薄[うす]い 上着[うわぎ]が 欲[ほ]しい
歌	うた	a song
歌う	うたう	to sing
うち	うち	home; house; my place
生まれる	うまれる	to be born
海	うみ	sea, beach
売る	うる	to sell (v.t.)
うるさい	うるさい	noisy; annoying
上着	うわぎ	coat, jacket
絵	え	a painting; a picture; a drawing
映画	えいが	movie, film
映画館	えいがかん	movie theater, cinema
英語	えいご	English (language)
ええ	ええ	yes
駅	えき	station
エレベーター	エレベーター	elevator
～円	～えん	Yen
鉛筆	えんぴつ	pencil
お～	お～	honorable ~ (honorific)
美味しい	おいしい	delicious, tasty
多い	おおい	many; there are a lot
大きい	おおきい	big, large
大きな	おおきな	big
大勢	おおぜい	great number of people
お母さん	おかあさん	mother (formal)
お菓子	おかし	confections, sweets, snack
お金	おかね	money
起きる	おきる	to get up (e.g., from sleeping); to happen
置く	おく	to put; to lay; to place
奥さん	おくさん	(someone else's) wife (hon.)
お酒	おさけ	sake; alcohol
お皿	おさら	plate, dish
伯父; 叔父さん	おじさん	uncle, middle-aged man
おじいさん	おじいさん	grandfather, male senior citizen
教える	おしえる	to teach, to inform, to instruct
押す	おす	to push, to press, to stamp (e.g., a passport)
遅い	おそい	slow; (to be) late
お茶	おちゃ	(green) tea
お手洗い	おてあらい	toilet, restroom, bathroom (lit., a place to wash one's hands)
お父さん	おとうさん	father (formal)
弟	おとうと	younger brother
男	おとこ	man, male
男の子	おとこのこ	boy
一昨日	おととい	the day before yesterday
おととし	おととし	year before last
大人	おとな	adult
お腹	おなか	stomach
同じ	おなじ	same, identical
お兄さん	おにいさん	(someone else's) older brother (formal)
お姉さん	おねえさん	older sister (formal)
伯母さん; 叔母さん	おばさん	aunt
おばあさん	おばあさん	grandmother, female senior-citizen
お風呂	おふろ	a bath
お弁当	おべんとう	a boxed lunch
覚える	おぼえる	to learn, to commit to memory, to remember, to memorize
おまわりさん	おまわりさん	policeman (friendly term)
重い	おもい	heavy; serious
面白い	おもしろい	interesting, amusing
泳ぐ	およぐ	to swim
降りる	おりる	to get off
終る	おわる	to finish, to close
音楽	おんがく	Music
女	おんな	woman, female
女の子	おんなのこ	girl
～回	～かい	counter for occurrences (~ times)
～階	～かい	counter for stories (floors) of a building
外国	がいこく	foreign country; abroad
外国人	がいこくじん	foreigner
会社	かいしゃ	company, corporation
階段	かいだん	stairs
買い物	かいもの	shopping
買う	かう	to buy
返す	かえす	to return something
帰る	かえる	to go back, to go home, to return
顔	かお	face (body part)
かかる	かかる	it takes (amount of time, money) (v.i.)
鍵	かぎ	a lock; a key
書く	かく	to write
学生	がくせい	student
～か月	～かげつ	(number of) months
掛ける	かける	to put on (e.g., glasses); to hang (e.g., on a wall)
かける	かける	to dial/call (e.g., phone); to sit down
傘	かさ	umbrella, parasol
貸す	かす	to lend
風	かぜ	wind, breeze
風邪	かぜ	cold, flu
方	かた	-- honorific form for 人 (ひと) --; way of doing
家族	かぞく	family, members of a family
片仮名	かたかな	katakana
～月	～がつ	month of year
学校	がっこう	a school
カップ	カップ	cup
家庭	かてい	home; family
角	かど	corner (e.g., desk, pavement)
かばん	かばん	bag, basket
花瓶	かびん	(flower) vase
かぶる	かぶる	to wear, to put on (e.g., a hat on the head)
紙	かみ	paper
カメラ	カメラ	camera
火曜日	かようび	Tuesday
辛い	からい	hot and spicy; salty
体	からだ	body; health
借りる	かりる	to borrow, to owe
～がる	～がる	feel
軽い	かるい	light, non-serious, minor
カレー	カレー	curry (abbr. for curry and rice)
カレンダー	カレンダー	calendar
川; 河	かわ	river
～側	～がわ	~ side
可愛い	かわいい	cute, adorable
漢字	かんじ	kanji; Chinese character
木	き	tree, wood, timber
黄色	きいろ	yellow
黄色い	きいろい	yellow
消える	きえる	to vanish, to disappear
聞く	きく	to hear, to listen, to ask
北	きた	north
ギター	ギター	guitar
汚い	きたない	dirty, unclean, filthy
喫茶店	きっさてん	café
切手	きって	postal (postage) stamps
切符	きっぷ	a ticket
昨日	きのう	yesterday
九	きゅう	nine
牛肉	ぎゅうにく	beef
牛乳	ぎゅうにゅう	milk
今日	きょう	today, this day
教室	きょうしつ	classroom
兄弟	きょうだい	siblings (humble), brothers and sisters
去年	きょねん	last year
嫌い	きらい	dislike
切る	きる	to cut; to hang up (a phone)
着る	きる	to put on (clothes above your waist); to wear
綺麗	きれい	pretty, clean, tidy
キロ; キログラム	キロ; キログラム	(abbr.) kilo (kilogram)
キロ; キロメートル	キロ; キロメートル	(abbr.) kilo (kilometer)
銀行	ぎんこう	bank
金曜日	きんようび	Friday
九	く	nine
薬	くすり	medicine
下さい	ください	(with te-form verb) please do for me
果物	くだもの	fruit
口	くち	job opening; mouth
靴	くつ	shoes, footwear
靴下	くつした	socks
国	くに	country; place of origin
曇り	くもり	cloudiness, cloudy weather
曇る	くもる	to become cloudy, to become dim
暗い	くらい	dark, gloomy
～くらい; ぐらい	～くらい; ぐらい	approximate (quantity)
クラス	クラス	a class
グラム	グラム	gram
来る	くる	to come
車	くるま	car, vehicle
黒	くろ	black
黒い	くろい	black; dark
警官	けいかん	police officer
今朝	けさ	this morning
消す	けす	to erase, to delete, to turn off power
結構	けっこう	splendid; enough, tolerably
結婚	けっこん (する)	marriage (get married)
月曜日	げつようび	Monday
玄関	げんかん	entrance (to a house or a building)
元気	げんき	health(y), energetic
～個	～こ	counter for small items (e.g., fruits, cups)
五	ご	five
～語	～ご	word, language
公園	こうえん	a park
交差点	こうさてん	intersection
紅茶	こうちゃ	black tea
交番	こうばん	police box
声	こえ	voice
コート	コート	coat; court (e.g., tennis)
コーヒー	コーヒー	coffee
ここ	ここ	here, this place
午後	ごご	afternoon, P.M.
九日	ここのか	nine days; ninth day of the month
九つ	ここのつ	nine things
午前	ごぜん	morning, A.M.
答える	こたえる	to answer, to reply
こちら	こちら	this person (polite); this way (polite)
こっち	こっち	this person; this direction; this side
コップ	コップ	a tumbler; a glass
今年	ことし	this year
言葉	ことば	language; word(s); expression(s)
子供	こども	child(ren)
この	この	this
御飯	ごはん	rice (cooked); meal
コピーする	コピーする	to copy
困る	こまる	to be bothered, to have difficulty
これ	これ	this one
～ころ; ～ごろ	～ころ; ～ごろ	about, toward, approximately (time)
今月	こんげつ	this month
今週	こんしゅう	this week
こんな	こんな	such, like this
今晩	こんばん	tonight, this evening
さあ	さあ	come now, well
～歳	～さい	~ years old
財布	さいふ	wallet
魚	さかな	fish
先	さき	future; recent, previous
咲く	さく	to bloom
作文	さくぶん	essay; composition
差す	さす	to raise (stretch out) hands, to raise (e.g., umbrella)
～冊	～さつ	counter for books
雑誌	ざっし	magazine, journal
砂糖	さとう	sugar
寒い	さむい	cold (in reference to weather)
さ来年	さらいねん	year after next
～さん	～さん	Mr. ~, Ms. ~
三	さん	three
散歩	さんぽ (する)	walk, stroll
四	し	four
～時	～じ	~ o'clock (time)
塩	しお	salt
しかし	しかし	however; but
時間	じかん	time
～時間	～じかん	~ hours
仕事	しごと	work, job, occupation, employment
辞書	じしょ	dictionary
静か	しずか	quiet, calm
下	した	under, below, beneath
七	しち	seven
質問	しつもん	question, inquiry
自転車	じてんしゃ	bicycle
自動車	じどうしゃ	automobile
死ぬ	しぬ	to die
字引	じびき	dictionary
自分	じぶん	myself, oneself
閉まる	しまる	to close, to be closed  ドアは 自動[じどう]で 閉[し]まる  そのお 店[みせ]はいつも 夜[よる] 8時[はちじ]に 閉[し]まる
閉める	しめる	to close, to shut  ドアを 閉[し]める
締める	しめる	to tie, to fasten, to tighten
じゃ; じゃあ	じゃ; じゃあ	well, well then
写真	しゃしん	a picture; a photograph
シャツ	シャツ	shirt
シャワー	シャワー	shower
十	じゅう	ten
～中	～じゅう	during, while
～週間	～しゅうかん	~ weeks
授業	じゅぎょう	a class (of school)
宿題	しゅくだい	homework
上手	じょうず	be good at, skillful
丈夫	じょうぶ	strong, solid, durable
醤油	しょうゆ	soy sauce
食堂	しょくどう	cafeteria, dining hall
知る	しる	to know, to understand
白	しろ	white
白い	しろい	white
～人	～じん	counter for people
新聞	しんぶん	newspaper
水曜日	すいようび	Wednesday
吸う	すう	to breathe in, to suck
スカート	スカート	skirt
好き	すき	liking, fondness, love
～すぎ	～すぎ	past; to exceed, ~ too much
少ない	すくない	a little; a few
すぐに	すぐに	immediately, soon
少し	すこし	little, few
涼しい	すずしい	cool, refreshing (in reference to weather)
～ずつ	～ずつ	at a time  一人ずつ入ってください Enter one person each time
ストーブ	ストーブ	heater (lit: stove)
スプーン	スプーン	spoon
スポーツ	スポーツ	sport(s)
ズボン	ズボン	trousers
住む	すむ	to reside, to live in
する	する	to do, to try; to wear small items (e.g., necktie, watch, etc.)
座る	すわる	to sit
背	せい	(one's) height, stature
生徒	せいと	student; pupil
セーター	セーター	sweater
石鹸	せっけん	soap
背広	せびろ	men's suit
狭い	せまい	narrow; not spacious
ゼロ	ゼロ	zero
千	せん	thousand
先月	せんげつ	last month
先週	せんしゅう	last week
先生	せんせい	teacher, professor; master; doctor
洗濯	せんたく	washing, laundry
全部	ぜんぶ	all, entire, whole
そう; そうです	そう; そうです	yes; appears, to be the case
掃除	そうじ (する)	cleaning, sweeping
そうして; そして	そうして; そして	and, like that
そこ	そこ	that place, there; bottom, sole
そちら	そちら	over there
そっち	そっち	over there
外	そと	outside, exterior
その	その	that
そば	そば	near, close, beside; Japanese traditional buckwheat noodle
空	そら	sky
それ	それ	that one
それから	それから	and then, after that
それでは	それでは	in that situation, well then...
～台	～だい	counter for vehicles; machines
大学	だいがく	college; university
大使館	たいしかん	embassy
大丈夫	だいじょうぶ	It's ok (all right); No need to worry; Everything is under control
大好き	だいすき	very like-able, like very much
大切	たいせつ	important
台所	だいどころ	kitchen
大変	たいへん	very; difficult, hard
高い	たかい	tall, high; expensive
～だけ	～だけ	only ~, just ~, as ~
沢山	たくさん	many, much
タクシー	タクシー	taxi
出す	だす	to take (something) out; to hand in (something)
～たち	～たち	plural suffix
立つ	たつ	to stand up
たて	たて	length, height
建物	たてもの	building
楽しい	たのしい	enjoyable, fun
頼む	たのむ	to request, to ask (a favor)
たばこ	たばこ	tobacco, cigarettes
多分	たぶん	perhaps, probably, maybe
食べ物	たべもの	food
食べる	たべる	to eat
卵	たまご	egg
誰	だれ	who
誰か	だれか	someone
誕生日	たんじょうび	birthday
段々	だんだん	gradually, by degrees
小さい	ちいさい	small, little
小さな	ちいさな	small, little
近い	ちかい	near, close by, short
違う	ちがう	to be different; to differ; wrong
近く	ちかく	nearby; in the neighborhood
地下鉄	ちかてつ	underground train, subway
地図	ちず	a map
父	ちち	(my) father
茶色	ちゃいろ	brown
茶碗	ちゃわん	rice bowl
～中	～ちゅう	during, while ~ing
丁度	ちょうど	just, right, exactly
ちょっと	ちょっと	a little, somewhat; just a little, somewhat
一日	ついたち	one day; first day of the month
使う	つかう	to use
疲れる	つかれる	to get (become) tired; to become fatigued
次	つぎ	next
着く	つく	to arrive at, to reach  公園に着く
机	つくえ	desk
作る	つくる	to make, to create
つける	つける	to turn on (e.g., a light); to take  明かりをつける turn on a light
勤める	つとめる	to work (for)
つまらない	つまらない	boring, dull; insignificant
冷たい	つめたい	cold (things, people)
強い	つよい	strong, powerful
手	て	hand
テープ	テープ	tape
テープレコーダー	テープレコーダー	tape recorder
テーブル	テーブル	table
出かける	でかける	to go out; to depart
手紙	てがみ	letter
できる	できる	to be able to (to accomplish)
出口	でぐち	an exit
テスト	テスト	test
では	では	then, well, so  では＝それでは
デパート	デパート	(abbr.) department store
でも	でも	but, however
出る	でる	to appear, to leave
テレビ	テレビ	television, TV
天気	てんき	weather
電気	でんき	electricity, (electric) light
電車	でんしゃ	electric train
電話	でんわ	a telephone
戸	と	door (Japanese style)
～度	～ど	counter for occurrences; ~ degree; ~ point
ドア	ドア	door (Western style)
トイレ	トイレ	bathroom; toilet
どう	どう	how, in what way
どうして	どうして	why, for what reason
どうぞ	どうぞ	please, kindly, by all means
動物	どうぶつ	animal
どうも	どうも	Thank you; somehow; no matter how hard one may try
十	(〜を) とお	ten (~)
遠い	とおい	far (away), distant
十日	とおか	ten days; tenth day of the month
～時	～とき	at the time of ~
時々	ときどき	sometimes
時計	とけい	a watch; a clock
どこ	どこ	where, what place
所	ところ	place
年	とし	year, age
図書館	としょかん	library
どちら	どちら	which (one) (way); where (polite)
どっち	どっち	which one, which way
とても	とても	very (much), greatly, exceedingly
どなた	どなた	who
隣	となり	next to, next door to
どの	どの	which
飛ぶ	とぶ	to fly, to hop
止まる	とまる	to come to a halt
友達	ともだち	friend
土曜日	どようび	Saturday
鳥	とり	chicken (lit., bird)
鶏肉	とりにく	chicken meat
取る	とる	to take (a class); to get (a grade)  いちごを取る take a strawberry
撮る	とる	to take (a photo), to make (a film)  写真を撮る to take photos
どれ	どれ	which one
どんな	どんな	what, what kind of
ない	ない	there isn't, doesn't have
ナイフ	ナイフ	knife
中	なか	inside, middle, among
長い	ながい	long, lengthy
鳴く	なく	to make sound (animal)  キリンってなんて 鳴[な]くんだろう？ What noise do giraffes make?
無くす	なくす	to lose something
なぜ	なぜ	why (same as どうして)
夏	なつ	summer
夏休み	なつやすみ	summer vacation
～など	～など	et cetera
七つ	ななつ	seven things
何	なん; なに	what
七日	なのか	seven days; seventh day (of the month)
名前	なまえ	name
習う	ならう	to learn
並ぶ	ならぶ	to line up, to stand in a line (v.i.)    列[れつ]に 並ぶ get in line
並べる	ならべる	to put (things) side by side; to line up
なる	なる	to become
何～	なん～	what sort of ~
二	に	two
にぎやか	にぎやか	bustling, busy
肉	にく	meat
西	にし	west
～日	～にち	~ day of the month, for ~ days
日曜日	にちようび	Sunday
荷物	にもつ	luggage; baggage
ニュース	ニュース	news
庭	にわ	garden
～人	～にん	counter for people
脱ぐ	ぬぐ	to take off (clothes)
温い	ぬるい	lukewarm
ネクタイ	ネクタイ	tie, necktie
猫	ねこ	cat
寝る	ねる	to sleep; to go to sleep; to go to bed
～年	～ねん	~ years
ノート	ノート	notebook
登る	のぼる	to climb
飲み物	のみもの	drink, beverage
飲む	のむ	to drink
乗る	のる	to get on, to ride in, to board
歯	は	tooth
パーティー	パーティー	a party
はい	はい	yes
～杯	～はい	counter for cupfuls (cups eg. tea)  一杯[いっぱい]のお 茶[ちゃ]  cup of tea
灰皿	はいざら	ashtray
入る	はいる	to enter, to contain, to hold
葉書	はがき	postcard
はく	はく	to put on (items below your waist)
箱	はこ	box
橋	はし	bridge
箸	はし	chopsticks
始まる	はじまる	(something) begins
初め; 始め	はじめ	beginning, start
初めて	はじめて	for the first time
走る	はしる	to run
バス	バス	bus; bath; bass
バター	バター	butter
二十歳	はたち	20 years old
働く	はたらく	to work
八	はち	eight
二十日	はつか	twenty days, twentieth (day of the month)
花	はな	flower
鼻	はな	nose
話	はなし	talk (chat), story
話す	はなす	to speak
母	はは	(my) mother
早い	はやい	early
速い	はやい	fast, quick
春	はる	spring
貼る	はる	to post; to paste; to attach   机[つくえ]にシールを 貼[は]った  I put a sticker on the desk
晴れ	はれ	clear (sunny) weather
晴れる	はれる	to be sunny   明日は晴れるでしょう。  It will be sunny tomorrow.
半	はん	half (e.g., にじはん | half-past two)
晩	ばん	evening
～番	～ばん	~st; ~th best
パン	パン	bread
ハンカチ	ハンカチ	handkerchief
番号	ばんごう	number, series of digits
晩御飯	ばんごはん	dinner, evening meal
半分	はんぶん	half
東	ひがし	east
～匹	～ひき	counter for small animals
引く	ひく	to pull, to draw; subtract    赤[あか]い 台車[だいしゃ]を 引[ひ]く pull a red wagon
弾く	ひく	to play (a string instrument or piano)
低い	ひくい	short, low    低[ひく]い 得点[とくてん] low score       背[せい]が 低[ひく]い short body
飛行機	ひこうき	airplane
左	ひだり	left hand side
人	ひと	man, person
一つ	ひとつ	one thing
一月	ひとつき	one month
一人	ひとり	one person
暇	ひま	free time, leisure
百	ひゃく	hundred
病院	びょういん	hospital
病気	びょうき	illness; sickness
平仮名	ひらがな	hiragana
昼	ひる	noon, daytime
昼御飯	ひるごはん	lunch, midday meal
広い	ひろい	spacious; wide; broad
フィルム	フィルム	film (roll of)
封筒	ふうとう	envelope
プール	プール	swimming pool
フォーク	フォーク	fork
吹く	ふく	空気[くうき]が 流[なが]れ 動[うご]く。 風[かぜ,]が 起[お]こる。 風[かぜ]が 通[かよ]ってゆく。 Air flows and moves. Wind happens. The wind passes.
服	ふく	clothes
二つ	ふたつ	two things
豚肉	ぶたにく	pork
二人	ふたり	two people
二日	ふつか	two days; second day of the month
太い	ふとい	fat, thick
冬	ふゆ	winter
降る	ふる	to precipitate, to fall (e.g., rain, snow, etc.)
古い	ふるい	old (in reference to objects, not people), aged, ancient
～分	～ふん	~ minutes
文章	ぶんしょう	sentence, text
ページ	ページ	a page
下手	へた	unskillful, poor
ベッド	ベッド	bed
ペット	ペット	pet
部屋	へや	a room
辺	へん	area, vicinity  あの辺は雪が深い。  The snow is deep around there.
ペン	ペン	pen
勉強	べんきょう (する)	study
便利	べんり	convenient, handy
帽子	ぼうし	hat; cap
ボールペン	ボールペン	ball-point pen
外	ほか	other, the rest
ポケット	ポケット	pocket
欲しい	ほしい	to want, in need of
ポスト	ポスト	mailbox; post, position
細い	ほそい	thin, slender, fine   彼女[かのじょ]の 首[くび]は 細[ほそ]い
ボタン	ボタン	button
ホテル	ホテル	hotel
本	ほん	book
～本	～ほん	counter for long cylindrical things
本棚	ほんだな	bookshelf
本当	ほんとう	real, true
～枚	～まい	紙[かみ]・ 板[いた]・ 皿[さら]などの 薄[うす]く 平[ひら]たいものを 数[かぞ]えるのに 用[もち]いる Used to count thin, flat objects such as paper, boards, plates, etc.
毎朝	まいあさ	every morning
毎月	まいげつ; まいつき	every month, monthly
毎週	まいしゅう	every week
毎日	まいにち	every day
毎年	まいねん; まいとし	every year, yearly, annually
毎晩	まいばん	every night
前	まえ	before, in front
～前	～まえ	in front of ~
曲る	まがる	to turn, to bend
まずい	まずい	terrible (in reference to food), unappetizing, unpleasant (taste)
また	また	and; furthermore, again
まだ	まだ	yet, still, besides  まだ寒い。 It’s still cold
町	まち	town; city
待つ	まつ	to wait
まっすぐ	まっすぐ	straight (ahead), direct  まっすぐ 行[い]ってください
マッチ	マッチ	match
窓	まど	window
丸い; 円い	まるい	物[もの]に 角[かど] (かど) がない。また、 曲線[きょくせん]を 描[えが]いている The object has no corners. Also, it is curved.
万	まん	ten thousand
万年筆	まんねんひつ	fountain pen
磨く	みがく	to brush (teeth); to polish
右	みぎ	right hand side
短い	みじかい	short (length)  短い髪
水	みず	water
店	みせ	store, shop
見せる	みせる	to show, to display
道	みち	road, street; way, directions
三日	みっか	three days, third day of the month
三つ	みっつ	three things
緑	みどり	green
皆さん	みなさん	all of you, everyone
南	みなみ	South
耳	みみ	ear
見る	みる	to see, to look
みんな	みんな	all, everyone, everybody
六日	むいか	six days; sixth day of month
向こう	むこう	beyond, over there  向こうを見て Look over there.
難しい	むずかしい	difficult
六つ	むっつ	six things
村	むら	village
目	め	eye(s)
メートル	メートル	meter
眼鏡	めがね	eye glasses
もう	もう	already; again; more
木曜日	もくようび	Thursday
もしもし	もしもし	Hello? (used on the phone)
持つ	もつ	to hold, to carry; to possess
もっと	もっと	more
物	もの	thing (concrete object)
門	もん	gate
問題	もんだい	a problem
～屋	～や	~ shop
八百屋	やおや	greengrocer
野菜	やさい	vegetable
易しい	やさしい	easy, plain, simple
安い	やすい	inexpensive; cheap (things)
休み	やすみ	holiday; day off; absence  今日は休みです
休む	やすむ	to rest, to have a break, to get time off  ベッドで休む
八つ	やっつ	eight things
山	やま	mountain
やる	やる	to do; to give (to pets, parents, siblings, etc.)
夕方	ゆうがた	late afternoon (typically just before dinner time), evening
夕飯	ゆうはん	dinner, supper, evening meal
郵便局	ゆうびんきょく	post office
昨夜	ゆうべ	last night
有名	ゆうめい	famous
雪	ゆき	snow
ゆっくりと	ゆっくりと	slowly, at ease
八日	ようか	eight days; eighth day of the month
洋服	ようふく	Western-style clothes
よく	よく	frequently, often (much); well, skillfully
横	よこ	beside; side; width   彼女[かのじょ]は 娘[むすめ]の 横[よこ]に 寝[ね]ている。  She sleeps beside her daughter.
四日	よっか	four days; fourth day of the month
四つ	よっつ	four things
呼ぶ	よぶ	to call (one's name); to invite
読む	よむ	to read
夜	よる	evening, night
弱い	よわい	weak
来月	らいげつ	next month
来週	らいしゅう	next week
来年	らいねん	next year
ラジオ	ラジオ	radio
ラジオカセ	ラジオカセ	radio cassette player
りっぱ	りっぱ	splendid, fine   彼女[かのじょ]の 演技[えんぎ]はりっぱ Her performance is splendid
留学生	りゅうがくせい	international student
両親	りょうしん	parents (lit., both parents)
料理	りょうり	cooking; cuisine
旅行	りょこう	travel, trip
零	れい	zero, nought
冷蔵庫	れいぞうこ	refrigerator
レコード	レコード	record
レストラン	レストラン	restaurant
練習	れんしゅう (する)	(to) practice
廊下	ろうか	corridor
六	ろく	six
ワイシャツ	ワイシャツ	shirt (lit: white shirt), business shirt
若い	わかい	young
分かる	わかる	to understand
忘れる	わすれる	to forget
私	わたし	I, myself
私	わたくし	I (formal), myself, private affairs
渡す	わたす	to hand (something) over (v.t.); to get across
渡る	わたる	to cross over, to go across   通[とお]りを 渡[わた]る 前[まえ]に 左右[さゆう]を 見[み]た。  I looked left and right before crossing the street.
悪い	わるい	bad, sinful; inferior
踏む	ふむ	to step on, to tread on
～区	～く	~ district, ~ ward, ~ borough
すっと	すっと	straight, quickly   彼女[かのじょ]はすっと 立[た]ち 教室[きょうしつ]から 出[で]て 行[い]った She stood straight up and went out of the classroom
盗む	ぬすむ	to steal; to rob
大抵	たいてい	generally, usually
とうとう	とうとう	finally, at last  とうとう日本に来たぞ We’re finally in Japan!
ガソリン	ガソリン	gasoline, petrol
鳴る	なる	to sound, to ring (v.i.)
しっかり	しっかり	firmly, steady   両手[りょうて]でしっかり 持って Hold it firmly with both hands  しっかり 息[いき]をはいてください Please exhale deeply
生きる	いきる	to live   生[い]きるのが 苦[くる]しい Life is hard
苦い	にがい	bitter
沸く	わく	to boil, to grow hot
意見	いけん	opinion, view, idea
やはり; やっぱり	やはり; やっぱり	as I thought, absolutely
漫画	まんが	comic (book), cartoon
ステレオ	ステレオ	stereo
医学	いがく	medical science
テキスト	テキスト	text; text book
～月	～つき	month
折る	おる	to snap, to break; to bend   骨[ほね]を 折[お]る break a bone/to make efforts   紙を 三角形[さんかくけい]に 折る Fold the paper into a triangle
～会	～かい	~ meeting
うかがう	うかがう	to ask
聞こえる	きこえる	to be heard, to be audible
僕	ぼく	I (used by men towards those of equal or lower status)
必ず	かならず	surely, certainly
壊す	こわす	to break, to break down  そんなに食べたらお腹壊すよ If you eat that much, you'll have a stomachache.
怒る	おこる	to get angry; to scold angrily
床屋	とこや	barber's (shop)
オートバイ	オートバイ	motorcycle (lit: auto-bi(ke))
運動	うんどうする	exercise
止む	やむ	to cease, to stop   雨はもうすぐ止むでしょう  The rain is probably going to stop soon.
もし	もし	if
表	おもて	surface; front; outside  シャツを 裏表[うらおもて]に 着[き]ていますよ You are wearing your shirt inside-out
大学生	だいがくせい	college student, university student
運転手	うんてんしゅ	driver (by occupation)
予習	よしゅう	preparation of lessons (for class)  明日の予習をしましょう Let's prepare for tomorrow
心配	しんぱいする	worry, concern
別	べつ	distinction, different
非常に	ひじょうに	extremely; very
お宅	おたく	(someone else's) house; home -- polite word for 家 (いえ) --
柔らかい	やわらかい	soft (in reference to texture), tender  柔らかいタオル
拾う	ひろう	to pick up (something), to find
～ございます	～ございます	to be (polite), to exist  ご 予約[よやく]はございますか Do you have reservations?
気	き	spirit, mood
比べる	くらべる	to compare   日本語は 他の 言語[げんご]と 比べると 抑揚[よくよう]がない In contrast to other languages, Japanese doesn't have intonation
ほとんど	ほとんど	mostly, almost  お金がほとんどありません I have little money.
つもり	つもり	intention, plan  日本に行くつもりだ  I intend to go to Japan
郊外	こうがい	suburb, outskirts  fewer big buildings and mainly houses, schools and shops
だめ	だめ	useless, no good, hopeless
売り場	うりば	place where things are sold
正月	しょうがつ	New Year, New Year's Day
規則	きそく	rule, regulation
うん	うん	yes (informal), all right (ok)
発音	はつおん	pronunciation
焼く	やく	to bake, to grill   焼肉[やきにく]
屋上	おくじょう	rooftop
失礼	しつれい	discourtesy, impoliteness; Excuse me
ごみ	ごみ	trash, garbage
アフリカ	アフリカ	Africa
点	てん	mark, score, grade; point, dot
一生懸命	いっしょうけんめい	"very hard (as in ""to work hard""), with utmost effort"
今度	こんど	now, this time, near future, one of these days, next time
機会	きかい	chance, opportunity
建てる	たてる	to build
複雑	ふくざつ	complexity, complication
彼	かれ	he, boyfriend
いらっしゃる	いらっしゃる	-- honorific expression for いく, くる, and いる --
布団	ふとん	futon
大事	だいじ	important, valuable, serious matter
贈り物	おくりもの	a gift; a present  すてきな 贈[おく]り 物[もの]をどうもありがとう。  Thank you for the wonderful gift.
泥棒	どろぼう	thief; burglar
～製	～せい	made in/of ~   木製[もくせい]のテーブル  wooden table
注意	ちゅうい	caution, attention
台風	たいふう	typhoon
日	ひ	sun, sunshine, day
～軒	～けん	counter for houses  一軒[いっけん]も 店[みせ]が 開[あ]いていません。 There were no stores open
そう	そう	really, (is that) so; yes, right
通る	とおる	to pass (by), to go through   通[つう]: Expert 通[つう]じる: Communicate, be understood  通[とお]る: pass by, go through 通[とお]り: avenue, street 通[とお]す: Force through  通[かよ]う: commute, go to and from
過ぎる	すぎる	to exceed, to go beyond  お金を使い過ぎる
レポート; リポート	レポート; リポート	report
葉	は	leaf
必要	ひつよう	necessary
課長	かちょう	section manager
地震	じしん	earthquake
すると	すると	and, then
止める	やめる	to end, to stop   予定[よてい]していたことなどを 行[おこな]わないことにする
ガラス	ガラス	glass, pane
～学部	～がくぶ	department of a university
厳しい	きびしい	hard; rigorous; strict
エスカレーター	エスカレーター	escalator
人口	じんこう	population
月	つき	moon
絹	きぬ	silk
ちっとも	ちっとも	not at all (neg. verb)   このケーキはちっともおいしくない。 This cake is not delicious at all.
深い	ふかい	deep, profound
壊れる	こわれる	to be broken, to break
揺れる	ゆれる	to shake, to sway   風[かぜ]で 旗[はた]がばたばた 揺[ゆ]れる  Flags flapping/shaking/swaying in the wind
落る	おちる	to fall, to drop  (intransitive 動詞)
できるだけ	できるだけ	if at all possible, as much as possible  できるだけ早く来てください。 Please come as soon as possible.
悲しい	かなしい	sad, sorrowful
中学校	ちゅうがっこう	junior high school
ガス	ガス	gas
祈る	いのる	to pray; to wish
盛ん	さかん	prosperous, active, thriving  祭りが盛んだ Festivals are lively/thriving
アルバイト	アルバイト	part-time job
起こす	おこす	to wake (someone) up
致す	いたす	-- extra-modest expression for する --
噛む	かむ	to bite, to chew
赤ちゃん	あかちゃん	baby, infant
浅い	あさい	shallow, superficial
嘘	うそ	lie
小説	しょうせつ	novel
親	おや	a parent
それに	それに	moreover; besides
西洋	せいよう	the West, Western countries
思う	おもう	to think, to feel
パート (タイム)	パート (タイム)	part time (esp. female part time employees)
時代	じだい	age, period, epoch, era  高校時代はとても楽しかった
申し上げる	もうしあげる	(humble)to say, to tell  お 礼[れい]の 申[もう]し 上[あ]げようもありません。 There are no words to express my gratitude.
～式	～しき	~ ceremony; ~ style   卒業式[そつぎょうしき] graduation ceremony   結婚式[けっこんしき] wedding ceremony   物理[ぶつり]の 公式[こうしき] physics formula
出席	しゅっせきする	attendance
～家	～か	person who is specialized in ~   芸術家[げいじゅつか] artist    翻訳家[ほんやくか] language translator
迎える	むかえる	to welcome; to meet; to greet   家族[かぞく]が 出迎[でむか]える His family welcomes him
触る	さわる	to touch, to feel
～建て	～だて	~ storied, separate housing   二階建[にかいだ]ての 家[いえ] two-story house
社長	しゃちょう	president of a company
動物園	どうぶつえん	zoo
捕まえる	つかまえる	to catch, to arrest   警察[けいさつ]が 容疑者[ようぎしゃ]を 捕[つか]まえた The policeman got the suspect
季節	きせつ	season (in reference to weather)
寄る	よる	ある 所[ところ]へ 向[む]かう 途中[とちゅう]で、 他[ほか]の 所[ところ]を 訪[おとず]れる。 立[た]ち 寄[よ]る On the way to one place, visit another. Stopover
決まる	きまる	to be set; fixed (v.i.) Rule-d (Fixed rule) Decide  決[けっ]して: never 決[き]める: To decide 決[き]まる: Be decided, fixed 決[き]まり: Rule regulation, custom, habit
開く	ひらく	to open; to hold (an event)
逃げる	にげる	to escape, to run away  逃げるな！ Don't run away!
だから	だから	so; therefore
残念	ざんねん	regret; regrettable
畳	たたみ	tatami mat (Japanese straw mat)
丁寧	ていねい	polite, courteous, careful
地理	ちり	geography
さっき	さっき	a little while ago
怖い	こわい	scary, frightening
包む	つつむ	to wrap, to cover
なるべく	なるべく	if possible, as much as possible  なるべく 早[はや]く 来[き]てください
無理	むり	unreasonable, impossible
サンドイッチ	サンドイッチ	sandwich
会議室	かいぎしつ	conference/meeting room
品物	しなもの	goods
人形	にんぎょう	doll, figure
利用	りよう	use, utilization  私はJRを、よく利用する。 I often use the JR lines.
飾る	かざる	to decorate, to adorn
止める	とめる	to stop (something)   意味[いみ]： 動[うご]いているものを 動[うご]かなくすること To make something that is moving stop moving
恥ずかしい	はずかしい	ashamed, embarrassed
いくら～ても	いくら～ても	however much one may ~  いくら勉強しても no matter how much you study
用事	ようじ	しなくてはならない 事柄[ことがら]。 用件[ようけん]。 A matter that must be done  事柄: matter, affair, circumstance 用件: things to be done
ビル	ビル	(abbr.) building
喧嘩する	けんかする	quarrel, fight, argument
頑張る	がんばる	to try one's best, to try hard, to persist
投げる	なげる	to pitch, to cast away   石[いし]を 投[な]げる throw a rock
故障	こしょうする	breakdown  また 車[くるま]が 故障[こしょう]しました。 My car broke down again.
力	ちから	strength, power
受ける	うける	to take (an examination, interview, etc.); to receive   様々[さまざま]な 国[くに]から 援助[えんじょ]を 受[う]ける。  They receive aid from different countries.
気分	きぶん	feeling, mood
間違える	まちがえる	to make a mistake
そんな	そんな	such, like that, that sort of
星	ほし	star
場合	ばあい	case, situation
やっと	やっと	at last, finally
足りる	たりる	to be sufficient; to be enough
行う	おこなう	to carry out; to conduct (typically used in written language)
葡萄	ぶどう	grapes
無くなる	なくなる	to disappear, to get lost  元気が無くなる lose one's energy/strength
準備	じゅんびする	prepare
世界	せかい	world
住所	じゅうしょ	address; place of residence
再来月	さらいげつ	the month after next Next two month
林	はやし	woods, forest
倍	ばい	double
痩せる	やせる	to lose weight
線	せん	line, wire   地下鉄[ちかてつ] 線[せん] subway line   赤[あか]で 下線[かせん]を 引[ひ]く underline with red
戦争	せんそう	war
決める	きめる	to decide (v.t.)   決[けっ]して: never  決[き]める: To decide  決[き]まる: Be decided, fixed  決[き]まり: Rule regulation, custom, habit
調べる	しらべる	to check; to look up; to inquire; to search
寝坊	ねぼう	oversleep  よく寝坊する Often oversleeps
パパ	パパ	papa, daddy
光る	ひかる	to shine, to glitter
夫	おっと	husband
雲	くも	cloud
坂	さか	slope, hill
～(て) しまう	～(て) しまう	to end up ~  一 年[ねん]が 無駄[むだ]になってしまう A whole year would be(end up) wasted
飛行場	ひこうじょう	airport
柔道	じゅうどう	judo
決して	けっして	never   決[けっ, け]して 諦[あきら]めないで 下[くだ]さい。  Never give up.  決[けっ]して: never 決[き]める: To decide 決[き]まる: Be decided, fixed 決[き]まり: Rule regulation, custom, habit
事務所	じむしょ	office
連絡	れんらく	communication, contact, connection
小学校	しょうがっこう	elementary school
客	きゃく	guest, customer
昔	むかし	old days; past
美しい	うつくしい	beautiful, lovely
捨てる	すてる	throw away (trash), dump, discard
なさる	なさる	-- honorific expression for する --
事	こと	thing(s), matter(s), fact
どんどん	どんどん	quickly and steadily; at a rapid pace
試合	しあい	match, game, competition
適当	てきとう	fitness, suitability   適当[てきとう]な 答[こた]え Appropriate answer
素晴らしい	すばらしい	wonderful; terrific
美術館	びじゅつかん	art gallery, art museum
文法	ぶんぽう	grammar
終わり	おわり	end    終[お]わりました！  I'm done!
壁	かべ	wall
一度	いちど	once, one time
お礼	おれい	expression of gratitude; thanking; gift of appreciation; bow
親切	しんせつ	kindness
知らせる	しらせる	to notify/tell/make someone 知る
歯医者	はいしゃ	dentist
熱心	ねっしん	enthusiasm
始める	はじめる	to start, to begin
もらう	もらう	to receive   お金をもらう
泣く	なく	to cry
治る	なおる	to get better; to recover from illness (v.i.)
熱	ねつ	fever, temperature
お祭り	おまつり	festival
水道	すいどう	water service, water line
匂い	におい	odor, smell
ベル	ベル	bell
赤ん坊	あかんぼう	baby
おかしい	おかしい	strange; odd; funny
事故	じこ	accident
変	へん	strange, odd
辞典	じてん	encyclopedia, reference book
残る	のこる	to remain (v.i.), to be left
立てる	たてる	to stand (something) up, to erect (something)  お 正月[しょうがつ]の 計画[けいかく]を 立[た]てる Planning for New Year's Day
くれる	くれる	to give, to do for
～員	～いん	member of ~
原因	げんいん	cause, origin, source
驚く	おどろく	to be surprised, to be astonished
いただく	頂く	-- extra-modest expression for たべる and のむ; humble expression for もらう --
祖母	そぼ	grandmother
場所	ばしょ	place, location
答	こたえ	answer, response
もちろん	もちろん	certainly, of course
漬ける	つける	to soak, to moisten, to pickle
受付	うけつけ	reception(ist) desk
内	うち	within, inside
スクリーン	スクリーン	screen
増える	ふえる	to increase, to multiply
または	または	or, otherwise
けがする	けがする	injury (to animate object), hurt
以下	いか	less than, below
選ぶ	えらぶ	to choose; to select
～ばかり	～ばかり	just did ~, only
心	こころ	heart, mind
～だす	～だす	to start doing ~
サラダ	サラダ	salad
届ける	とどける	to deliver (v.t.)
挨拶	あいさつする	greet(ing)   彼女[かのじょ]は 笑顔[えがお]で 挨拶[あいさつ]した
景色	けしき	scenery, landscape
確か	たしか	if I remember correctly; certain, definite
ステーキ	ステーキ	steak
食料品	しょくりょうひん	foodstuff, groceries
森	もり	forest
以内	いない	within, less (no more) than
予定	よてい	plans, arrangement, schedule
オーバー	オーバー	overcoat; over, exceeding, exaggeration
乾く	かわく	to get dry
石	いし	stone
思い出す	おもいだす	to recall, to remember
踊る	おどる	to dance
細かい	こまかい	small; fine, minute
塗る	ぬる	to paint, to plaster
ご主人	ごしゅじん	(your, her) husband
珍しい	めずらしい	unusual, rare
用	よう	errand, task, business (to take care of)
公務員	こうむいん	government worker, public servant
お嬢さん	おじょうさん	(someone's) daughter (polite)
用意	ようい	preparation
探す	さがす	to search, to seek, to look for
形	かたち	shape
運転	うんてんする	driving
すっかり	すっかり	all, completely   体[からだ]がすっかり 回復[かいふく]した  I've fully recovered.
アナウンサー	アナウンサー	announcer
お土産	おみやげ	souvenir
消しゴム	けしゴム	eraser
旅館	りょかん	a Japanese inn
海岸	かいがん	coast, seashore
寂しい	さびしい	lonely, lonesome
火	ひ	fire
育てる	そだてる	to raise (v.t.); to bring up  子供を育てるのは大変だ
味噌	みそ	miso, bean paste
お祝い	おいわい	congratulation, celebration
乗り物	のりもの	vehicle
案内	あんないする	information, guidance
通う	かよう	to go back and forth; to commute
連れる	つれる	to lead, to take (a person)
技術	ぎじゅつ	technique, technology, skill
小鳥	ことり	small bird
下宿	げしゅく	lodging, boarding house   親類[しんるい]の 家に4 年間下宿しました I boarded at my relative's house for four years.
ジャム	ジャム	jam
招待	しょうたいする	invitation
鏡	かがみ	mirror
はず	はず	it should be so
法律	ほうりつ	law
進む	すすむ	to advance, to proceed
楽む	たのしむ	to enjoy
貿易	ぼうえき	trade
反対	はんたい	oppose, opposition, resistance
おる	おる	-- extra-modest expression for いる --
申す	もうす	-- extra-modest (humble) expression for  言[い]う --   鈴木[すずき]と 申[もう]します This is Suzuki speaking
試験	しけん	an exam
真面目	まじめ	diligent, serious
ごらんになる		-- honorific expression for みる --
店員	てんいん	clerk; shop-employee
泊まる	とまる	to stay (over night) (v.i.)
よろしい	よろしい	(hon.) good, OK, all right
今夜	こんや	this evening, tonight
おつり	おつり	change; balance of money returned to the purchaser
チェックする	チェックする	check
会話	かいわ	conversation
空気	くうき	air, atmosphere
交通	こうつう	traffic, transportation
ワープロ	ワープロ	word processor
喜ぶ	よろこぶ	to rejoice, to be delighted, to be glad
急行	きゅうこう	express train or bus
皆	みな	everyone
味	あじ	flavor, taste
空港	くうこう	airport
手袋	てぶくろ	glove(s)
校長	こうちょう	principal, headmaster
ごちそう	ごちそう	feast, treating (someone)
踊り	おどり	dance
興味	きょうみ	interest (in something)
引っ越す	ひっこす	to move to a new place of residence
冷房	れいぼう	cooling, air conditioning
都合	つごう	circumstances, convenience 今日は都合がいいです。 Today is convenient for me.
遠慮	えんりょする	restraint, reserve, hesitate
亡くなる	なくなる	to pass away
科学	かがく	science
はっきり	はっきり	clearly, distinctly
差し上げる	さしあげる	-- humble expression for あげる to give--
気持ち	きもち	feeling, sensation, mood
祖父	そふ	grandfather
港	みなと	harbor, port
予約	よやく	reservation
凄い	すごい	terrific, great
入学	にゅうがくする	entry to school or university
片付ける	かたづける	to (clean) tidy up (v.t.), to put away
写す	うつす	to copy (v.t.); to photograph
パソコン	パソコン	(personal) computer
部長	ぶちょう	department (division) manager
火事	かじ	fire
足す	たす	to add (numbers)
教会	きょうかい	church
彼ら	かれら	they (usually male)
一杯	いっぱい	full, to the utmost
アメリカ	アメリカ	America, U.S.A.
男性	だんせい	man; male
理由	りゆう	reason
生産	せいさんする	production; to produce
着物	きもの	kimono; Japanese traditional dress
おもちゃ	おもちゃ	a toy
暮れる	くれる	to get dark, to come to an end  もう 少[すこ]しで 日[ひ]が 暮[く]れる The sun is going to go down soon.
釣る	つる	to fish
～ちゃん	～ちゃん	suffix for familiar (female) person
打つ	うつ	to hit, to strike
あんな	あんな	such, like that
謝る	あやまる	to apologize
昼間	ひるま	daytime, during the day
教育	きょういく	education
女性	じょせい	woman
米	こめ	uncooked rice
邪魔	じゃま	hindrance, intrusion
国際	こくさい	international
隅	すみ	corner
伺う	うかがう	humble form of 行く (いく), 聞く (きく) and 来る (くる)
再来週	さらいしゅう	the week after next
夢	ゆめ	a dream
喉	のど	throat
最近	さいきん	recently, nowadays, in recent years, most recent, latest
周り	まわり	surroundings
歴史	れきし	history
不便	ふべん	inconvenience   家[いえ]が 不便[ふべん]な 所[ところ]にある。 The house is inconveniently situated.
血	ち	blood
～続ける	～つづける	to continue doing ~
毛	け	hair, fur
ひどい	ひどい	terrible, awful, unfair, cruel
例えば	たとえば	for example, e.g.
中々	なかなか	very, considerably, quite
随分	ずいぶん	extremely
～やすい	～やすい	easy to do ~
押し入れ	おしいれ	closet
電灯	でんとう	electric light
叱る	しかる	to scold
サンダル	サンダル	sandal
びっくりする	びっくりする	to be surprised
うまい	うまい	delicious; skillful; fortunate
変える	かえる	to change, to alter, to vary
講堂	こうどう	auditorium
子	こ	child
沸かす	わかす	to boil
レジ	レジ	register
しばらく	しばらく	little while
特に	とくに	particularly
空く	あく	to open, to become empty (vacant)
計画	けいかくする	plan, project, schedule
通り	とおり	~ Street, ~ Avenue
下着	したぎ	underwear
経済	けいざい	economics, finance, economy
こう	こう	like this, this way
是非	ぜひ	certainly, by all means; without fail   是非[ぜひ]、また 会[あ]いましょう We'll definitely see you again!
裏	うら	reverse side, back   広[ひろ]い 裏庭[うらにわ] Spacious backyard   健[けん]は 俺[おれ]たちを 裏切[うらぎ]った　Ken betrayed us.
為	ため	good, advantage, in order to
おいでになる	おいでになる	「 行く・ 来る・いる」の 尊敬語[そんけいご] (honirific language)
変わる	かわる	to change (v.i.), to be transformed, to vary  天気は変わる
以外	いがい	other than, with the exception of, excepting
済む	すむ	to finish, to end
ハンバーグ	ハンバーグ	hamburger steak
市	し	city
引き出し	ひきだし	drawer
遊び	あそび	play
支度	したくする	preparation
～始める	～はじめる	to start doing ~
見える	みえる	to be visible; -- polite verb meaning 来る (くる) --  私何歳に見える？ How old do I look?  トムが見える。 I see Tom
十分	じゅうぶん	enough
音	おと	sound, note
きっと	きっと	surely, definitely, undoubtedly, certainly
まず	まず	first (of all), to start with
遠く	とおく	far away, distant
大体	だいたい	approximately; in most cases; in general; to begin with (same as もともと)
折れる	おれる	to break, to be folded, to give in; to turn (a corner)
正しい	ただしい	correct
輸入	ゆにゅう	import
返事	へんじ	reply, answer
都	と	metropolitan
産業	さんぎょう	industry
伝える	つたえる	to convey (a message); to tell, to report
お金持ち	かねもち; おかねもち	rich person
説明	せつめい	explanation
島	しま	island
道具	どうぐ	tool
滑る	すべる	to slide, to slip    雨[あめ]の 後[あと]は 道路[どうろ]が 滑[すべ]る
それほど	それほど	to that degree; extent
以上	いじょう	more than; this is all
～まま	～まま	as it is
特急	とっきゅう	limited express (train faster than an express)
プレゼント	プレゼント	present, gift
～(に) よると	～(に) よると	according to ~   天気予報[てんきよほう]によると 明日[あした]は 晴[は]れです。 The weather forecast says it will be fine tomorrow.
妻	つま	wife (humble)
帰り	かえり	return, coming back
具合	ぐあい	condition, state, health
堅; 硬; 固い	かたい	solid, hard, firm
駐車場	ちゅうしゃじょう	parking lot
スーツ	スーツ	suit
危険	きけん	danger, risk, hazard
髪	かみ	hair
天気予報	てんきよほう	weather forecast
彼女	かのじょ	girlfriend; she
間	あいだ	space, interval
卒業	そつぎょう	graduation
それで	それで	and (conj.), thereupon, because of that
枝	えだ	branch, twig
専門	せんもん	major; speciality
そろそろ	そろそろ	gradually, soon
送る	おくる	to send, to dispatch
あげる	あげる	to give
騒ぐ	さわぐ	to make noise, to clamor
尋ねる	たずねる	to inquire (same as 質問する)
放送	ほうそうする	broadcasting
政治	せいじ	politics
市民	しみん	citizen
ファックス	ファックス	fax
負ける	まける	to lose (a game) (v.i.), to be defeated
指輪	ゆびわ	(finger) ring
田舎	いなか	rural, countryside
見つける	みつける	to discover, to find (v.t.)
高校生	こうこうせい	high school student
講義	こうぎ	a lecture
そんなに	そんなに	so much, like that
昼休み	ひるやすみ	lunch break, noon recess
忘れ物	わすれもの	lost article, something forgotten
下りる	おりる	to get down, to go; come down
腕	うで	arm (in reference to body)
訳	わけ	reason; explanation
承知	しょうちする	consent, acceptance
日記	にっき	diary, journal
高校; 高等学校	こうこう; こうとうがっこう	high school; senior high school
似る	にる	to resemble, to be similar
～おわる	～おわる	to finish doing ~
暖房	だんぼう	heating
留守	るす	absence; not at home  父は今、留守です My father isn't at home now.
割合	わりあい	rate, ratio, percentage
寺	てら	Buddhist temple
慣れる	なれる	to grow accustomed to
普通	ふつう	common; usual
手伝う	てつだう	to help
なるほど	なるほど	I see; I now understand
くださる	くださる	(hon.) to give, to confer
息子	むすこ	(humble) son
お子さん	おこさん	(someone else's) child (polite)
会場	かいじょう	venue, meeting place
笑う	わらう	to laugh, to smile
運ぶ	はこぶ	to transport, to carry
文学	ぶんがく	literature
光	ひかり	light
お見舞い	おみまい	calling on someone who is ill, visit
席	せき	a seat
～様	～さま	Mr., Mrs., Ms.
ご存じ	ごぞんじ	knowing, acquaintance
下る	さがる	to descend, to drop, to fall   値段[ねだん]がさ 下[さ]がった the price has dropped
字	じ	letter; character
アジア	アジア	Asia
褒める	ほめる	to praise; to say nice things
空く	すく	to be empty (in reference to people), to be less crowded   席[せき]が 空[す]く have a seat available
あ	あ	Ah
最も	もっとも	most
合う	あう	to fit, to match
～代	～だい	~ age; period   古代[こだい]エジプト ancient Egypt
最後	さいご	last, end
値段	ねだん	price
退院	たいいんする	leaving hospital
展覧会	てんらんかい	exhibition   彼女[かのじょ]は 絵[え]を 展覧会[てんらんかい]に 出品[しゅっぴん]した She presented pictures in the exhibition.
久しぶり	ひさしぶり	it has been a long time; for the first time in a long time
カーテン	カーテン	curtain
汽車	きしゃ	train (steam)
遅れる	おくれる	to (be) become late
見つかる	みつかる	to be found (v.i.), to be discovered   犯人[はんにん]が 見[み]つかるのだろうか？ Will they find the culprit?
召し上がる	めしあがる	-- honorific form of 食べる (たべる) and 飲む (のむ) --
太る	ふとる	to gain weight
注射	ちゅうしゃ	injection
様	よう	way, manner, kind
～おき	～おき	after every ~   2日[ふつか]おきにジョギングをします。 After every 2days I go jogging
最初	さいしょ	beginning, first
御～	ご～	honorable ~
安心	あんしん	peace of mind, relief
直る	なおる	to be fixed
集める	あつめる	to collect, to gather (v.t.), to assemble
直す	なおす	to correct (v.t.); to fix
続く	つづく	to be continued
先輩	せんぱい	senior members of a group
約束	やくそく	arrangement, appointment, promise
世話	せわする	looking after; to look after
近所	きんじょ	neighborhood
将来	しょうらい	(in the) future; prospects
億	おく	hundred million
数学	すうがく	mathematics
文化	ぶんか	culture
払う	はらう	to pay
習慣	しゅうかん	Habit, custom (in reference to culture)
焼ける	やける	to burn, to be roasted
君	きみ	you (informal for men)
冷える	ひえる	to grow cold, to cool down
点く	つく	to be started, to be switched on  ライトが 点[つ]く turn on the light
この間	このあいだ	the other day, recently
格好	かっこう	appearance, manner, shape, form, posture  トムは 格好[かっこう]いい Tom is good looking/cool.
構う	かまう	to mind, to care about, to be concerned about   意見[いけん]を 全[まった]く 構[かま]わない completely unconcerned about one's opinion
続ける	つづける	to continue, to keep up
落す	おとす	to drop, to lose   彼[かれ]はかびん 花瓶[かびん]をお 落[お]とした He dropped a vase.
明日	あす	tomorrow
出発	しゅっぱつする	departure
拝見	はいけんする	(humble) (polite) seeing, look at   切符[きっぷ]を 拝見[はいけん]します。 May I see your ticket?  (lit: I will look at your ticket.)
割れる	われる	to break   卵[たまご]が 割[わ]れる
背中	せなか	back (of body)
新聞社	しんぶんしゃ	newspaper company
いじめる	いじめる	to bully, to torment
回る、回す	まわる、まわす	to go around, to revolve   下着[したぎ]のまま、 家[いえ]の 中[なか]を 歩[ある]き 回[まわ]る人もいる。 Some people walk around their homes in their underwear.
～君	～くん	Mr. (junior) ~, master ~
おっしゃる	おっしゃる	-- honorific expression for いう（言う） --
眠い	ねむい	sleepy, drowsy
濡れる	ぬれる	to get wet
倒れる	たおれる	to collapse, to break down, fell   彼[かれ]はよこ 横[よこ]にばったりたお 倒[たお]れた He fell flat on his side.
スーパー (マーケット)	スーパー (マーケット)	supermarket
アクセサリー	アクセサリー	accessory
考える	かんがえる	to think (about); to consider
向かう	むかう	to face, to go towards
自由	じゆう	freedom
仕方	しかた	way (of doing something)
首	くび	neck
程	ほど	degree, extent   冗談[じょうだん]にも 程[ほど]がある。 Jokes do have limits.
代わり	かわり	substitute, replacement  ご飯のお代わりをください Please give me another bowl of rice
失敗	しっぱい	failure, mistake
工業	こうぎょう	(manufacturing) industry
移る	うつる	to move (from a house); to transfer (from a department); to shift
スーツケース	スーツケース	suitcase
髭	ひげ	beard
研究室	けんきゅうしつ	the professor's office; laboratory
工場	こうじょう	factory
紹介	しょうかい	an introduction
けれど; けれども	けれど; けれども	but, although
舟	ふね	ship, boat
動く	うごく	to move
～(に) ついて	～(に) ついて	about, concerning
コンサート	コンサート	concert
虫	むし	insect
優しい	やさしい	kind (person), gentle (person), easy (problem)
コンピュータ; コンピューター	コンピュータ; コンピューター	computer
植える	うえる	to plant
両方	りょうほう	both sides, both parties
汚れる	よごれる	to become dirty
水泳	すいえい	swimming
経験	けいけんする	experience   1 To actually see, hear, or do. Also, knowledge, skills, etc. gained by doing so. To accumulate, to be shallow, or to work in a variety of departments.   2 In philosophy, that which is given directly by sense or perception.
勝つ　勝	かつ　 しょう	勝[か]つ　 勝[しょう] to win　Win
砂	すな	sand
警察	けいさつ	police; police station
取り替える	とりかえる	to exchange, to replace
急ぐ	いそぐ	to hurry, to be in a hurry, to rush    急[いそ]ぐととかく 失敗[しっぱい]しがちだ  If you hurry it's easy to make mistakes.
簡単	かんたん	simple
参る	まいる	humble expression for 行く and 来る
全然	ぜんぜん	not at all; wholly, entirely
特別	とくべつ	special
復習	ふくしゅう	review (of lessons), revision
間に合う	まにあう	to be in time for
役に立つ	やくにたつ	to be helpful, to be useful
もうすぐ	もうすぐ	very soon; in a few moments; days  もうすぐ春ですね It'll be spring soon.
真中	まんなか	middle, center
戻る	もどる	to return (v.i.); to come back
研究	けんきゅう	study, research, investigation
ケーキ	ケーキ	cake
草	くさ	grass
込む	こむ	to be crowded
この頃	このごろ	these days, nowadays
訪ねる	たずねる	to visit
下げる	さげる	to lower (v.t.); to hang   値[あたい]を 下[さ]げる lower the price
花見	はなみ	cherry-blossom viewing   毎年お花見をする I do cherry blossom viewing every year
途中	とちゅう	on the way, midway   途中[とちゅう]で 諦[あきら]めないで Don’t give up halfway through.
入院	にゅういんする	hospitalization
乗り換える	のりかえる	to transfer (trains), to change (bus, train, etc.)
別れる	わかれる	to part from, to separate
～町	～ちょう	the town of ~
安全	あんぜん	safety, security
看護婦	かんごふ	(female) nurse
見物	けんぶつ	sightseeing
相談	そうだんする	consultation
ガソリンスタンド	ガソリンスタンド	gas station, service station
テニス	テニス	tennis
眠る	ねむる	to sleep
上がる	あがる	to rise, to go up
翻訳	ほんやく	translation
食事	しょくじする	meal
お陰	おかげ	thanks or owing to  お陰さまで皆元気です Thanks to you, everyone is doing well.
娘	むすめ	daughter (humble)
湯	ゆ	hot water
競争	きょうそう	competition, contest
会議	かいぎ	business meeting; conference
湖	みずうみ	lake
集まる	あつまる	to gather (v.i.), to collect
～難い	～にくい	difficult to do ~
生活	せいかつする	living, life; to live   生活[せいかつ]が 苦[くる]しい。 hard to make a living
糸	いと	thread
関係	かんけい	relation(ship), connection
ピアノ	ピアノ	piano
～目	～め	number ~ sequence, ~nd; ~th   二番[にばん] 目[め] second place   一回[いっかい] 目[め]は 失敗[しっぱい]した。 The first time was a failure.
番組	ばんぐみ	broadcast program
急	きゅう	urgent, sudden; steep   急[いそ]いで！Hurry!  急[きゅう]な 右折[うせつ] Sharp right turn
棚	たな	shelves, rack
木綿	もめん	cotton
輸出	ゆしゅつする	export
タイプ	タイプ	type, style
すり	すり	pickpocket
嬉しい	うれしい	to be happy; to be glad
アルコール	アルコール	alcohol
ソフト	ソフト	soft; soft hat; software
神社	じんじゃ	Shinto shrine
大分	だいぶ	fairly well, to a large extent, considerably, pretty much   大分[だいぶ] 早[はや]く 着[つ]きましたね。 We arrived fairly early.
楽しみ	たのしみ	pleasure, joy  楽しみだ！ I'm looking forward to it!
趣味	しゅみ	hobby; pastime
電報	でんぽう	telegram
家内	かない	(one's own) wife
指	ゆび	finger
これから	これから	from now on, after this
たまに	たまに	occasionally   彼[かれ]はたまに 料理[りょうり]をします
社会	しゃかい	society
